[
  "   1         ",
  "             ",
  "   S         ",
  "        B    ",
  "  2    BW    ",
  "      B      ",
  "     B       ",
  "             ",
  "       1     ",
  "             ",
  "   2         ",
  "         TTTT"
]
