[
  "             ",
  "             ",
  "   S         ",
  "        B    ",
  "       BW    ",
  "      B      ",
  "     B       ",
  "             ",
  "             ",
  "             ",
  "             ",
  "         TTTT"
]